10 10
##########
#x###e####
#x#e######
#x########
#xxxxxxxx#
#xxxxxxxx#
#x########
#x###f####
#x#f######
##########